(9-1-1) complex	9_1_1
14-3-3	p14_3_3
14-3-3 proteins	p14_3_3
4EBP	EIF4EBP
5-hydroxytryptamine-receptors-G-protein-coupled	5_hydroxytryptamine_receptors_G_protein_coupled
5-hydroxytryptamine-receptors-ionotropic	5_hydroxytryptamine_receptors_ionotropic
55S Mitoribosome	Mitochondrial_Ribosome
55S mammalian mitochondrial ribosome	Mitochondrial_Ribosome
55S mitoribosome	Mitochondrial_Ribosome
55s Mitoribosome	Mitochondrial_Ribosome
55s mitoribosome	Mitochondrial_Ribosome
9-1-1	9_1_1
9-1-1 complex	9_1_1
A2t	Annexin_II_heterotetramer
A4GALT-family	A4GALT_family
ABL	ABL_family
ABL family	ABL_family
ABL-family	ABL_family
ACAD	ACAD
ACC	ACC
ACCs	ACC
ACOX	ACOX
ACS	Acetyl_CoA_synthetase
ACSL	ACSL
ACTN	ACTN
ADCY	ADCY
ADH	ADH
ADORA	ADORA
ADP ribosylation factor	ARF_GTPase_family
ADRA	ADRA
ADRA2	ADRA2
ADRB	ADRB
ADRBK	ADRBK
AGTR	AGTR
AKT	AKT
AKT family	AKT
ALDH	ALDH
ALDO	ALDO
ALG1-family	ALG1_family
ALG10	ALG10
ALG13-family	ALG13_family
ALG3-family	ALG3_family
ALG6-family	ALG6_family
AMLC	MYL_alkali
AMP-activated	AMPK
AMPA glutamate receptor	GRIA
AMPA receptor	GRIA
AMPA-R	GRIA
AMPA-subtype ionotropic glutamate receptors	GRIA
AMPAR	GRIA
AMPARs	GRIA
AMPK	AMPK
AMPK (A1/B1/G1)	AMPK_A1B1G1
AMPK (A1/B1/G2)	AMPK_A1B1G2
AMPK (A1/B1/G3)	AMPK_A1B1G3
AMPK (A1/B2/G1)	AMPK_A1B2G1
AMPK (A1/B2/G2)	AMPK_A1B2G2
AMPK (A1/B2/G3)	AMPK_A1B2G3
AMPK (A2/B1/G1)	AMPK_A2B1G1
AMPK (A2/B1/G2)	AMPK_A2B1G2
AMPK (A2/B1/G3)	AMPK_A2B1G3
AMPK (A2/B2/G1)	AMPK_A2B2G1
AMPK (A2/B2/G2)	AMPK_A2B2G2
AMPK (A2/B2/G3)	AMPK_A2B2G3
AMPK (alpha 1, beta 1, gamma 1)	AMPK_A1B1G1
AMPK (alpha 1, beta 1, gamma 2)	AMPK_A1B1G2
AMPK (alpha 1, beta 1, gamma 3)	AMPK_A1B1G3
AMPK (alpha 1, beta 2, gamma 1)	AMPK_A1B2G1
AMPK (alpha 1, beta 2, gamma 2)	AMPK_A1B2G2
AMPK (alpha 1, beta 2, gamma 3)	AMPK_A1B2G3
AMPK (alpha 2, beta 1, gamma 1)	AMPK_A2B1G1
AMPK (alpha 2, beta 1, gamma 2)	AMPK_A2B1G2
AMPK (alpha 2, beta 1, gamma 3)	AMPK_A2B1G3
AMPK (alpha 2, beta 2, gamma 1)	AMPK_A2B2G1
AMPK (alpha 2, beta 2, gamma 2)	AMPK_A2B2G2
AMPK (alpha 2, beta 2, gamma 3)	AMPK_A2B2G3
AMPK (α 1, β 1, γ 1)	AMPK_A1B1G1
AMPK (α 1, β 1, γ 2)	AMPK_A1B1G2
AMPK (α 1, β 1, γ 3)	AMPK_A1B1G3
AMPK (α 1, β 2, γ 1)	AMPK_A1B2G1
AMPK (α 1, β 2, γ 2)	AMPK_A1B2G2
AMPK (α 1, β 2, γ 3)	AMPK_A1B2G3
AMPK (α 2, β 1, γ 1)	AMPK_A2B1G1
AMPK (α 2, β 1, γ 2)	AMPK_A2B1G2
AMPK (α 2, β 1, γ 3)	AMPK_A2B1G3
AMPK (α 2, β 2, γ 1)	AMPK_A2B2G1
AMPK (α 2, β 2, γ 2)	AMPK_A2B2G2
AMPK (α 2, β 2, γ 3)	AMPK_A2B2G3
AMPK a1b1g1	AMPK_A1B1G1
AMPK a1b1g2	AMPK_A1B1G2
AMPK a1b1g3	AMPK_A1B1G3
AMPK a1b2g1	AMPK_A1B2G1
AMPK a1b2g2	AMPK_A1B2G2
AMPK a2b1g1	AMPK_A2B1G1
AMPK a2b2g1	AMPK_A2B2G1
AMPK a2b2g2	AMPK_A2B2G2
AMPK a2b2g3	AMPK_A2B2G3
AMPK alpha1beta1gamma1	AMPK_A1B1G1
AMPK alpha1beta1gamma2	AMPK_A1B1G2
AMPK alpha1beta1gamma3	AMPK_A1B1G3
AMPK alpha1beta2gamma1	AMPK_A1B2G1
AMPK alpha1beta2gamma2	AMPK_A1B2G2
AMPK alpha1beta2gamma3	AMPK_A1B2G3
AMPK alpha2beta1gamma1	AMPK_A2B1G1
AMPK alpha2beta1gamma2	AMPK_A2B1G2
AMPK alpha2beta1gamma3	AMPK_A2B1G3
AMPK alpha2beta2gamma1	AMPK_A2B2G1
AMPK alpha2beta2gamma2	AMPK_A2B2G2
AMPK alpha2beta2gamma3	AMPK_A2B2G3
AMPK α1β1γ1	AMPK_A1B1G1
AMPK α1β1γ2	AMPK_A1B1G2
AMPK α1β1γ3	AMPK_A1B1G3
AMPK α1β2γ1	AMPK_A1B2G1
AMPK α1β2γ2	AMPK_A1B2G2
AMPK α1β2γ3	AMPK_A1B2G3
AMPK α2β1γ1	AMPK_A2B1G1
AMPK α2β1γ2	AMPK_A2B1G2
AMPK α2β1γ3	AMPK_A2B1G3
AMPK α2β2γ1	AMPK_A2B2G1
AMPK α2β2γ2	AMPK_A2B2G2
AMPK α2β2γ3	AMPK_A2B2G3
AMPK-A1B1G1	AMPK_A1B1G1
AMPK-A1B1G2	AMPK_A1B1G2
AMPK-A1B1G3	AMPK_A1B1G3
AMPK-A1B2G1	AMPK_A1B2G1
AMPK-A1B2G2	AMPK_A1B2G2
AMPK-A1B2G3	AMPK_A1B2G3
AMPK-A2B1G1	AMPK_A2B1G1
AMPK-A2B1G2	AMPK_A2B1G2
AMPK-A2B1G3	AMPK_A2B1G3
AMPK-A2B2G1	AMPK_A2B2G1
AMPK-A2B2G2	AMPK_A2B2G2
AMPK-A2B2G3	AMPK_A2B2G3
AMPK-alpha	AMPK_alpha
AMPK-beta	AMPK_beta
AMPK-gamma	AMPK_gamma
AMPKalpha	AMPK_alpha
AMPKα	AMPK_alpha
ANO	ANO
ANXA2 heterotetramer	Annexin_II_heterotetramer
AP-1	AP1
AP-2	Adaptor_protein_II
AP-2 adaptor complex	Adaptor_protein_II
AP-2 complex	Adaptor_protein_II
AP-2 transcription factor	TFAP2
AP-3	Adaptor_protein_III
AP1	AP1
AP2	Adaptor_protein_II
AP2 adaptor complex	Adaptor_protein_II
AP2 clathrin adaptor complex	Adaptor_protein_II
AP2 complex	Adaptor_protein_II
AP2A	AP2A
AP3	Adaptor_protein_III
APC-C	APC_C
APC/C	APC_C
APOA	APOA
AQP	AQP
ARF-GTPase-family	ARF_GTPase_family
ARRB	ARRB
ASIC	ASIC
ATG4	ATG4
ATP receptor	P2R
ATP receptors	P2R
ATP synthase	ATP_synthase
ATP synthase H + transporting mitochondrial F0 complex subunit G	ATP5G
ATP-synthase	ATP_synthase
ATP1A	ATP1A
ATP1B	ATP1B
ATP5G	ATP5G
ATPase Na+/K+ transporting subunit alpha	ATP1A
ATPase Na+/K+ transporting subunit beta	ATP1A
ATPase Na+/K+ transporting subunit α	ATP1A
ATPase Na+/K+ transporting subunit β	ATP1A
AXIN	AXIN
Acetate-CoA ligase	Acetyl_CoA_synthetase
Acetyl Coenzyme A Carboxylase	ACC
Acetyl-CoA carboxylase	ACC
Acetyl-CoA synthetase	Acetyl_CoA_synthetase
Acetyl-CoA-synthetase	Acetyl_CoA_synthetase
Acsl	ACSL
Actin	Actin
Actin-related protein	Actin_related_proteins
Actin-related proteins	Actin_related_proteins
Actin-related-proteins	Actin_related_proteins
Activin	Activin
Activin A	Activin_A
Activin A protein	Activin_A
Activin-A	Activin_A
Activin-AB	Activin_AB
Activin-B	Activin_B
Acyl-CoA Oxidase	ACOX
Adaptor Protein 2 complex	Adaptor_protein_II
Adaptor-protein	Adaptor_protein
Adaptor-protein-I	Adaptor_protein_I
Adaptor-protein-II	Adaptor_protein_II
Adaptor-protein-III	Adaptor_protein_III
Adaptor-protein-IV	Adaptor_protein_IV
Adaptor-protein-V	Adaptor_protein_V
Adenosine-deaminase-family	Adenosine_deaminase_family
Akt	AKT
Aldehyde dehydrogenase	ALDH
Alpha-1,2-glucosyltransferase	ALG10
Alpha-1,2-glucosyltransferases	ALG10
Alpha-1,3-glucosyltransferase	ALG6_family
Alpha-1,3-glucosyltransferases	ALG6_family
Alpha-1,4-glucosyltransferase	ALG6_family
Alpha-1,4-glucosyltransferases	ALG6_family
Angiotensin receptor	AGTR
Angiotensin receptors	AGTR
Annexin-II-heterotetramer	Annexin_II_heterotetramer
ApoA	APOA
Apolipoprotein	Apolipoprotein
Arp	Actin_related_proteins
Arp2-3-protein	Arp2_3_protein
Arp2/3	Arp2_3_protein
Atg4	ATG4
Augmin	Augmin
Axin	AXIN
Axonemal-dynein	Axonemal_dynein
Axonemal-dynein-IDA	Axonemal_dynein_IDA
Axonemal-dynein-ODA	Axonemal_dynein_ODA
B3GAT	B3GAT
BARK	ADRBK
BCKDC	BCKDC
BCKDH	BCKDC
BDKR	BDKR
BEST	BEST
BIRC	BIRC
BIRs	BIRC
BLVR	BLVR
BMP	BMP
BMP Receptor Type I	BMP_receptor_type_I
BMP Receptor Type II	BMP_receptor_type_II
BMP type I receptor	BMP_receptor_type_I
BMP type II receptor	BMP_receptor_type_II
BMP-receptor	BMP_receptor
BMP-receptor-type-I	BMP_receptor_type_I
BMP-receptor-type-II	BMP_receptor_type_II
BRCA	BRCA
BRCC3 isopeptidase complex	BRISC_complex
BRCC36 (BRCC3) isopeptidase complex	BRISC_complex
BRCC36 isopeptidase complex	BRISC_complex
BRI	BMP_receptor_type_I
BRII	BMP_receptor_type_II
BRISC deubiquinating enzyme complex	BRISC_complex
BRISC deubiquitinating enzyme complex	BRISC_complex
BRISC deubiquitylating enzyme complex	BRISC_complex
BRISC-complex	BRISC_complex
BVR	BLVR
Beta 3-glycosyltransferase	Beta_3_4_GTF
Beta 3-glycosyltransferases	Beta_3_4_GTF
Beta 4-glycosyltransferase	Beta_3_4_GTF
Beta 4-glycosyltransferases	Beta_3_4_GTF
Beta Tubulin	TUBB
Beta tubulin	TUBB
Beta-1,3-glucuronyltransferase	B3GAT
Beta-1,3-glucuronyltransferases	B3GAT
Beta-3-4-GTF	Beta_3_4_GTF
Beta-HEX	Beta_HEX
Beta-Tubulin	TUBB
Beta-hexosaminidase	Beta_HEX
Beta-tubulin	TUBB
C/EBP	CEBP
C1	C1
C1-complex	C1
C1q	C1q
CACN	CACN
CACNA1	CACNA1
CACNA2D	CACNA2D
CACNB	CACNB
CACNG	CACNG
CALM	CALM
CAM-KII	CAMK2_complex
CAMK	CAMK
CAMK-II	CAMK2_complex
CAMK2	CAMK2_complex
CAMK2-complex	CAMK2_complex
CAMK2-family	CAMK2_family
CAMKII	CAMK2_complex
CAP	CAP
CAPN	CAPN
CATSPER	CATSPER
CAV	CAV
CBF3	CBF3
CBF3 complex	CBF3
CCAAT/enhancer binding protein	CEBP
CCL	CCL
CCT	CCT_complex
CCT complex	CCT_complex
CCT-complex	CCT_complex
CD16	CD16
CD3	CD3
CD32	CD32
CD64	CD64
CD8	CD8
CDC25	CDC25
CDC25 family	CDC25
CDK	CDK
CDK activating kinase	CDK_activating_kinase_complex
CDK-activating-kinase-complex	CDK_activating_kinase_complex
CDK1-2	CDK1_2
CDK1/2	CDK1_2
CDKN	CDKN
CDKN1	CDKN1
CDKN2	CDKN2
CDKs	CDK
CEBP	CEBP
CHEK	CHEK
CHK	CHK
CHRM	CHRM
CHRN	CHRN
CK-1	CSNK1
CK-I	CSNK1
CK1	CSNK1
CK2	CK2
CKIs	CDKN
CLCN	CLCN
CLEC	CLEC
CLIC	CLIC
CLK	CLK
CNG	CNG
CNKSR	CNKSR
COL1	COL1
COL4	COL4
COL5	COL5
COLGALT	COLGALT
COX	COX
COX4	COX4
COX6A	COX6A
COX6B	COX6B
COX7A	COX7A
COX8	COX8
CREB	CREB
CREB family	CREB
CRISP	CRISP
CRISPs	CRISP
CRSP	CRSP
CRSP complex	CRSP
CRSP/Med complex	CRSP
CRTC	CRTC
CSNK	CSNK
CSNK1	CSNK1
CSNK2	CSNK2
CTNNA	CTNNA
CUL	CUL
CXCL-ELR-negative	CXCL_ELR_negative
CXCL-ELR-positive	CXCL_ELR_positive
CYP	CYP
CYP enzyme	CYP
CYP enzymes	CYP
CYP epoxygenase	CYP_epoxygenases
CYP epoxygenases	CYP_epoxygenases
CYP gene	CYP
CYP genes	CYP
CYP isoforms	CYP
CYP isozymes	CYP
CYP-epoxygenases	CYP_epoxygenases
CYP1	CYP1
CYP11	CYP11
CYP1s	CYP1
CYP2	CYP2
CYP26	CYP26
CYP27	CYP27
CYP3	CYP3
CYP3A enzymes	CYP3
CYP3A protein	CYP3
CYP4	CYP4
CYP450	CYP
CYP450 enzyme	CYP
CYP450 enzymes	CYP
CYP7	CYP7
CYP8	CYP8
CYPs	CYP
Ca(2+)-calmodulin-dependent protein kinase II	CAMK2_complex
Ca(2+)/calmodulin-dependent kinase II	CAMK2_complex
CaM	CALM
CaM kinase II	CAMK2_complex
CaM serine/threonine kinase II	CAMK2_complex
CaMK	CAMK
CaMK II	CAMK2_complex
CaMK family	CAMK
CaMK-II	CAMK2_complex
CaMK2	CAMK2_complex
CaMKII	CAMK2_complex
CaMKII protein	CAMK2_complex
CaN	PPP3
Cadherin	Cadherin
Calcineurin catalytic subunit	PPP3C
Calcineurin regulatory subunit	PPP3R
Calcium channel	Calcium_channels
Calcium channels	Calcium_channels
Calcium-channels	Calcium_channels
Calcium-sensing-receptors	Calcium_sensing_receptors
Calmodulin	CALM
Carboxylesterase	Carboxylesterase
Casein kinase 1	CSNK1
Caspase	Caspase
Caspase-3-7	Caspase_3_7
Cathepsin	Cathepsin
Cation channel	Cation_channels
Cation channels	Cation_channels
Cation-channels	Cation_channels
Caveolin	CAV
Cdc25	CDC25
Cdc25 phosphatases	CDC25
Cdk	CDK
Cdk1/2	CDK1_2
Cdkn1	CDKN1
Chemokine	Chemokine
Chemokine-receptor	Chemokine_receptor
Chk1/2	CHEK
Chloride-calcium-activated-channels	Chloride_calcium_activated_channels
Chloride-channels	Chloride_channels
Cholinesterase	Cholinesterase
Clade B serpin	SERPINB
Class 1 NF-kappaBs	NFkappaB_1
Class 1 NF-κBs	NFkappaB_1
Class 2 NF-kappaBs	NFkappaB_2
Class 2 NF-κBs	NFkappaB_2
Class C GPCR	GPCR_C
Class I HDACs	HDAC_I
Class I NF-kappaBs	NFkappaB_1
Class I NF-κBs	NFkappaB_1
Class II NF-kappaBs	NFkappaB_2
Class II NF-κBs	NFkappaB_2
Class III HDACs	HDAC_III
Class IV HDACs	HDAC_IV
Clathrin	Clathrin
Cofilin	Cofilin
Cohesin	Cohesin
Col4	COL4
ColIV	COL4
Collagen	Collagen
Collagen Type IV	COL4
Collagen beta(1-O)galactosyltransferase	COLGALT
Collagen beta(1-O)galactosyltransferases	COLGALT
Complex IV	COX
Connexin	GJ
Connexins	GJ
Cox4	COX4
Cox6a	COX6A
Cox6b	COX6B
Cox7a	COX7A
Cox7b	COX7B
Cox8	COX8
Creatine-kinase	Creatine_kinase
Cyclin	Cyclin
Cyclin A	Cyclin_A
Cyclin D	Cyclin_D
Cyclin-A	Cyclin_A
Cyclin-B	Cyclin_B
Cyclin-D	Cyclin_D
Cyclin-E	Cyclin_E
Cyclin-G	Cyclin_G
Cyclophilin	Cyclophilin
Cyp1	CYP1
Cyp26	CYP26
Cyp3a	CYP3
Cytochrome P-450	CYP
Cytochrome P450	CYP
Cytochrome c oxidase subunit 6a	COX6A
Cytochrome p450	CYP
Cytoplasmic dynein	Cytoplasmic_dynein
Cytoplasmic-dynein	Cytoplasmic_dynein
D-type cyclins	Cyclin_D
DAG kinase	DGK
DAPK	DAPK
DAPk	DAPK
DESI	DESI
DGC	DGC
DGK	DGK
DNA polymerase alpha	DNA_polymerase_alpha
DNA polymerase alpha-primase	DNA_polymerase_alpha
DNA polymerase delta	DNA_polymerase_delta
DNA polymerase δ	DNA_polymerase_delta
DNA replication factor C	RFC
DNA replication factor C complex	RFC
DNA-polymerase-alpha	DNA_polymerase_alpha
DNA-polymerase-delta	DNA_polymerase_delta
DNM	DNM
DNMT	DNMT
DP complex	TFDP
DRD	DRD
DUB	Deubiquitinase
DUBs	Deubiquitinase
DUSP	DUSP
DVL	DVL
DYNC1	DYNC1
DYNC2	DYNC2
DYRK	DYRK
Death-receptor	Death_receptor
Deiodinase	Deiodinase
Deoxyribonucleoside-kinases	Deoxyribonucleoside_kinases
Desmoglein	Desmoglein
Desumolating isopeptidase	DESI
Desumolating isopeptidases	DESI
Desumoylase	Desumoylase
Desumoylating isopeptidase	DESI
Desumoylating isopeptidases	DESI
Deubiquinatase	Deubiquitinase
Deubiquinatases	Deubiquitinase
Deubiquinating Enzyme	Deubiquitinase
Deubiquinating Enzymes	Deubiquitinase
Deubiquinating enzyme	Deubiquitinase
Deubiquinating enzymes	Deubiquitinase
Deubiquitinase	Deubiquitinase
Deubiquitinases	Deubiquitinase
Deubiquitinating Enzyme	Deubiquitinase
Deubiquitinating Enzymes	Deubiquitinase
Deubiquitinating enzyme	Deubiquitinase
Deubiquitinating enzymes	Deubiquitinase
Deubiquitylase	Deubiquitinase
Deubiquitylases	Deubiquitinase
Deubiquitylating Enzyme	Deubiquitinase
Deubiquitylating Enzymes	Deubiquitinase
Deubiquitylating enzyme	Deubiquitinase
Deubiquitylating enzymes	Deubiquitinase
Dgk	DGK
Dvl	DVL
Dynein	Dynein
Dyneins	Dynein
E2 conjugating enzyme	UBE2
E2 enzyme	UBE2
E2 ubiquitin-conjugating enzyme	UBE2
E2F	E2F
E3	E3_Ub_ligase
E3 ubiquitin ligase	E3_Ub_ligase
E3-Ub-ligase	E3_Ub_ligase
EDN	EDN
EDNR	EDNR
EEF	EEF
EEF1	EEF1
EEF1A	EEF1A
EEF1B	EEF1B
EFN	EFN
EGFR ligand	EGFR_ligand
EGFR ligands	EGFR_ligand
EGFR-ligand	EGFR_ligand
EGR	EGR
EIF2B	EIF2B
EIF4A	EIF4A
EIF4EBP	EIF4EBP
EIF4G	EIF4G
ELA	ELA
ELOVL	ELOVL
ELR (+) CXC chemokines	CXCL_ELR_positive
ELR (-) CXC chemokines	CXCL_ELR_negative
ELR-negative CXC chemokine	CXCL_ELR_negative
ELR-negative CXC family	CXCL_ELR_negative
ELR-positive CXC chemokine	CXCL_ELR_positive
ELR-positive CXC family	CXCL_ELR_positive
ENO	ENO
EPHA	EPHA
EPHB	EPHB
EPN	EPN
ERBB	ERBB
ERK	ERK
ERK 1/2	ERK
ERK MAPK	ERK
ERK mitogen-activated protein kinase	ERK
ERK-1/2	ERK
ERK1/2	ERK
ERK1/2 MAPK	ERK
ERKs	ERK
ERM	ERM
ERM protein	ERM
ERM proteins	ERM
ESR	ESR
ETC-complex-I	ETC_complex_I
ETC-complex-I-core	ETC_complex_I_core
ETC-complex-I-supernumerary	ETC_complex_I_supernumerary
ETC-complex-II	ETC_complex_II
ETC-complex-III	ETC_complex_III
ETC-complex-V	ETC_complex_V
ETNK	ETNK
ETS	ETS
EXOC	EXOC
EXT	EXT
Eotaxin	Eotaxin
Eph receptor	Ephrin_receptor
Eph receptors	Ephrin_receptor
EphB receptor	EPHB
Ephrin-receptor	Ephrin_receptor
ErbB	ERBB
Erk	ERK
Erk1/2	ERK
Exostosin glycosyltransferase family	EXT
Extracellular Signal Regulated Kinase	ERK
F-actin	F_actin
FABP	FABP
FANC	FANC
FANC proteins	FANC
FERMT	FERMT
FGF	FGF
FGFR	FGFR
FLOT	FLOT
FLRT	FLRT
FLRT family	FLRT
FLRT proteins	FLRT
FNR	FNR
FNT	FNT
FOS	FOS_family
FOS-family	FOS_family
FOX	FOX
FOX-A	FOXA
FOXA	FOXA
FOXB	FOXB
FOXC	FOXC
FOXD	FOXD
FOXD4L	FOXD4L
FOXE	FOXE
FOXF	FOXF
FOXF proteins	FOXF
FOXI	FOXI
FOXJ	FOXJ
FOXK	FOXK
FOXK proteins	FOXK
FOXKs	FOXK
FOXL	FOXL
FOXN	FOXN
FOXO	FOXO
FOXP	FOXP
FOXP proteins	FOXP
FOXR	FOXR
FPR	FPR
FSH	FSH
FTase	FNT
FUT	FUT
FZD	FZD
Fermitin	FERMT
Fermitins	FERMT
Fibrin	Fibrin
Fibrinogen	Fibrinogen
Flrt family	FLRT
Fos	FOS_family
FoxA	FOXA
FoxB	FOXB
FoxC	FOXC
FoxD	FOXD
FoxF	FOXF
FoxF proteins	FOXF
FoxK	FOXK
FoxL	FOXL
FoxO	FOXO
FoxP	FOXP
FoxP proteins	FOXP
FoxR	FOXR
Foxb	FOXB
Foxc	FOXC
Foxd	FOXD
Foxf	FOXF
Foxf family	FOXF
Foxf genes	FOXF
Foxk	FOXK
Foxk proteins	FOXK
Foxp	FOXP
Foxp proteins	FOXP
Fucosyltransferase	FUT
Fucosyltransferases	FUT
Fz	FZD
G S protein	G_s
G alpha	G_alpha
G alphaS	G_s_alpha
G alphai	G_i_alpha
G alphaq	G_q_alpha
G protein	G_protein
G protein Gs	G_s
G protein alpha	G_alpha
G protein beta	G_beta
G protein gamma	G_gamma
G protein gamma subunit	G_gamma
G protein β	G_beta
G protein γ	G_gamma
G protein γ subunit	G_gamma
G protein(s)	G_s
G protein-coupled receptor kinases	GRK
G proteins	G_protein
G αS	G_s_alpha
G αi	G_i_alpha
G αq	G_q_alpha
G(12)	G_12
G(q/11)	G_q
G-12	G_12
G-12-alpha	G_12_alpha
G-AlphaS	G_s_alpha
G-Protein alpha-i	G_i_alpha
G-Protein alpha-q	G_q_alpha
G-Protein alpha-s	G_s_alpha
G-Protein α-i	G_i_alpha
G-Protein α-q	G_q_alpha
G-Protein α-s	G_s_alpha
G-actin	G_actin
G-actins	G_actin
G-alpha	G_alpha
G-alpha(s)	G_s_alpha
G-beta	G_beta
G-gamma	G_gamma
G-i	G_i
G-i-alpha	G_i_alpha
G-protein	G_protein
G-protein alpha	G_alpha
G-protein alpha-12	G_12_alpha
G-protein beta	G_beta
G-protein α-12	G_12_alpha
G-protein β	G_beta
G-q	G_q
G-q-alpha	G_q_alpha
G-s	G_s
G-s-alpha	G_s_alpha
G-α	G_alpha
G-α(s)	G_s_alpha
G-αS	G_s_alpha
G12	G_12
G12 family	G_12
G12 proteins	G_12
G6Pase	G6Pase
GABA receptor	GABR
GABA receptors	GABR
GABA-A receptor	GABR
GABBR	GABBR
GABR	GABR
GAD	GAD
GALNT	GALNT
GAP	GAP
GARP	GARP
GAS6-receptor	GAS6_receptor
GATA	GATA
GATA family	GATA
GCNT	GCNT
GEF	GEF
GEFs	GEF
GII PLA2	PLA2G2
GIIPLA2	PLA2G2
GJ	GJ
GLRA-GLRB	GLRA_GLRB
GLUT	SLC2A
GNRH	GNRH
GOT	GOT
GPCR	GPCR
GPCR kinases	GRK
GPCR-C	GPCR_C
GPCR-C-orphans	GPCR_C_orphans
GPCRs	GPCR
GPI transamidase complex	GPIT
GPIT	GPIT
GPIT complex	GPIT
GPIb-IX-V	GPIb_IX_V
GPIb-IX-V complex	GPIb_IX_V
GPX	GPX
GRI	GRI
GRIA	GRIA
GRID	GRID
GRIN	GRIN
GRK	GRK
GRKs	GRK
GRM	GRM
GSK-3	GSK3
GSK3	GSK3
GST	GST
GSTs	GST
GTF-family-2	GTF_family_2
GTF-family-29	GTF_family_29
GTF-family-6	GTF_family_6
GTF-family-8	GTF_family_8
GTF-family-90	GTF_family_90
GTF2E	GTF2E
GTF2F	GTF2F
GTPase	GTPase
GTPase activating protein	GAP
GTPase-activating protein	GAP
GTPase-activating proteins	GAP
GUCY	GUCY
GUCY1A	GUCY1A
GUCY1B	GUCY1B
GYS	GYS
Ga12	G_12_alpha
Galpha	G_alpha
Galpha12	G_12_alpha
GalphaS	G_s_alpha
Galphai	G_i_alpha
Galphaq	G_q_alpha
Gamma tubulin	TUBG
Gamma-secretase	Gamma_secretase
Gas6 receptors	GAS6_receptor
Gbeta	G_beta
Gi	G_i
Gi alpha	G_i_alpha
Gi alpha subunit	G_i_alpha
Gi protein	G_i
Gi α	G_i_alpha
Gi α subunit	G_i_alpha
Glucose-6-phosphatase	G6Pase
Glutamate receptors, ionotropic, kainate	Kainate_family
Glycogen phosphorylase	PYG
Glycogen phosphorylases	PYG
Glycoprotein Ib-V-IX	GPIb_IX_V
Glycoprotein Ib/V/IX	GPIb_IX_V
Glycosyltransferase	Glycosyltransferase
Glycosyltransferase family 2	GTF_family_2
Glycosyltransferase family 29	GTF_family_29
Glycosyltransferase family 6	GTF_family_6
Glycosyltransferase family 8	GTF_family_8
Glycosyltransferase family 90	GTF_family_90
GnRH	GNRH
GnRh	GNRH
Gnrh	GNRH
Gonadotropin releasing hormone	GNRH
Gonadotropin-releasing hormone	GNRH
GpIb-V-IX	GPIb_IX_V
Gq alpha	G_q_alpha
Gq alpha subunit	G_q_alpha
Gq α	G_q_alpha
Gq α subunit	G_q_alpha
Gq/11	G_q
Growth factor	Growth_factor
Growth-factor	Growth_factor
Gs alpha	G_s_alpha
Gs alpha subunit	G_s_alpha
Gs family	G_s
Gs protein	G_s
Gs α	G_s_alpha
Gs α subunit	G_s_alpha
Gα12	G_12_alpha
GαS	G_s_alpha
Gαi	G_i_alpha
Gαq	G_q_alpha
Gβ	G_beta
H2B	Histone_H2B
H3	Histone_H3
H4	Histone_H4
HACD	HACD
HACD1-4	HACD
HAUS	Augmin
HAUS complex	Augmin
HDAC	HDAC
HDAC-I	HDAC_I
HDAC-II	HDAC_II
HDAC-III	HDAC_III
HDAC-IV	HDAC_IV
HDL	HDL
HECT E3 ligase	HECT_E3_ligase
HECT-E3-ligase	HECT_E3_ligase
HES	HES
HEX	HEX
HIF	HIF
HIF-1	HIF1
HIF-alpha	HIF_alpha
HIF-beta	HIF_beta
HIF1	HIF1
HIFalpha	HIF_alpha
HIFbeta	HIF_beta
HIFs	HIF
HIFα	HIF_alpha
HIFβ	HIF_beta
HLA-DR	HLA_DR
HLA1	HLA1
HLA2 alpha chain	HLA2_alpha
HLA2 beta chain	HLA2_beta
HLA2-alpha	HLA2_alpha
HLA2-beta	HLA2_beta
HMOX	HMOX
HOMER	HOMER
HRH	HRH
HSP70	HSPA
HSP90	HSP90
HSP90A	HSP90A
HSP90AA	HSP90AA
HSPA	HSPA
HSPB	HSPB
HSPB proteins	HSPB
HTR	HTR
HTR1	HTR1
HTR2	HTR2
HVCN	HVCN
Heat Shock Protein 70	HSPA
Hedgehog	Hedgehog
Hedgehog family	Hedgehog
Hemoglobin	Hemoglobin
Hes	HES
Hes gene family	HES
Hes genes	HES
Hexokinase	Hexokinase
Hgb	Hemoglobin
Hh	Hedgehog
Hifalpha	HIF_alpha
Hifbeta	HIF_beta
Hifα	HIF_alpha
Hifβ	HIF_beta
High-density lipoproteins	HDL
Histone	Histone
Histone 2A	Histone_H2A
Histone H2A	Histone_H2A
Histone-H1	Histone_H1
Histone-H2A	Histone_H2A
Histone-H2B	Histone_H2B
Histone-H3	Histone_H3
Histone-H4	Histone_H4
Homer	HOMER
Hsp70	HSPA
Hsp90	HSP90
ICAM	ICAM
IFITM	IFITM
IFN	Interferon
IFN-a	IFNA
IFN-alpha	IFNA
IFN-α	IFNA
IFNA	IFNA
IFNAR	IFNAR
IFNB	IFNB
IFNGR	Interferon_gamma_receptor
IFNalpha	IFNA
IFNα	IFNA
IGF-BP	IGFBP
IGFBP	IGFBP
IGFBPs	IGFBP
IK1	KCNJ
IKB	IKB
IKK	IKK_complex
IKK complex	IKK_complex
IKK-complex	IKK_complex
IKK-family	IKK_family
IL-1	IL1
IL-12	IL12
IL-15 receptor	IL15R
IL-15R	IL15R
IL-2 receptor	IL2R
IL-23	IL23
IL-2R	IL2R
IL1	IL1
IL1 family	IL1
IL12	IL12
IL15R	IL15R
IL23	IL23
IL2R	IL2R
IRS	IRS
IRS family	IRS
IRX	IRX
ITGA	ITGA
ITGA2B1	ITGA2B1
ITGA2B3	ITGA2B3
ITGB	ITGB
ITPR	ITPR
Ifnar	IFNAR
IkappaB	IKB
IkappaB kinase	IKK_complex
Il23	IL23
Inhibin	Inhibin
Inhibin-A	Inhibin_A
Inhibin-B	Inhibin_B
Insulin receptor family	INSR
Integrins	Integrins
Interferon	Interferon
Interferon beta	IFNB
Interferon β	IFNB
Interferon-alpha/beta receptor	IFNAR
Interferon-gamma-receptor	Interferon_gamma_receptor
Interleukin-23	IL23
Iroquois family	IRX
Iroquois proteins	IRX
Iroquois-class homeodomain proteins	IRX
IκB	IKB
IκB kinase	IKK_complex
JAB1/MPN/MOV34 Pad1 N-terminal (MPN) domain protease	JAMM
JAB1/MPN/MOV34 Pad1 N-terminal (MPN) domain proteases	JAMM
JAB1/MPN/MOV34 Pad1 N-terminal domain protease	JAMM
JAB1/MPN/MOV34 Pad1 N-terminal domain proteases	JAMM
JAB1/MPN/MOV34 Pad1 N-terminal+ (MPN) domain protease	JAMM
JAB1/MPN/MOV34 Pad1 N-terminal+ (MPN) domain proteases	JAMM
JAB1/MPN/MOV34 Pad1 N-terminal+ (MPN+) domain protease	JAMM
JAB1/MPN/MOV34 Pad1 N-terminal+ (MPN+) domain proteases	JAMM
JAB1/MPN/MOV34 Pad1 N-terminal+ domain protease	JAMM
JAB1/MPN/MOV34 Pad1 N-terminal+ domain proteases	JAMM
JAB1/MPN/MOV34 metalloenzyme	JAMM
JAB1/MPN/MOV34 metalloenzyme domain	JAMM
JAK	JAK
JAKs	JAK
JAMM	JAMM
JAMM deubiquinatase	JAMM
JAMM deubiquinatases	JAMM
JAMM deubiquitinase	JAMM
JAMM deubiquitinases	JAMM
JAMM deubiquitylase	JAMM
JAMM deubiquitylases	JAMM
JAMM family	JAMM
JNK	JNK
JNK MAPK	JNK
JNK1/2	JNK
JNKs	JNK
JUN	JUN_family
JUN-family	JUN_family
Jak	JAK
KARs	Kainate_family
KCN	KCN
KCNH	KCNH
KCNJ	KCNJ
KCNK	KCNK
KCNT	KCNT
KLK	KLK
KLKs	KLK
KMT	KMT
KSR	KSR
Kainate receptors	Kainate_family
Kainate-family	Kainate_family
Kindlin	FERMT
Kindlins	FERMT
Kinesin	Kinesin
Kinetochore	Kinetochore
Kir	KCNJ
LATS	LATS
LC3	MAP1LC3
LDH	LDH
LFA-1	LFA_1
LH	LH
LM-1	Laminin_111
LPAR	LPAR
LRRC8	LRRC8
LXR	LXR
LXRs	LXR
Laminin-111	Laminin_111
Laminin-332	Laminin_332
Laminin-5	Laminin_332
Large Mitoribosomal Subunit	MRPL
Let-7	MIRLET7
Let-7a	MIRLET7A
Let-7f	MIRLET7F
Ligand-gated ion channel	Ligand_gated_ion_channels
Ligand-gated ion channels	Ligand_gated_ion_channels
Ligand-gated-ion-channels	Ligand_gated_ion_channels
Liprin-alpha	Liprin_alpha
Liprin-α	Liprin_alpha
Liver X receptor	LXR
Liver X receptors	LXR
Luteinizing hormone	LH
MAC	MAC
MAC-1	MAC_1
MAP kinase	MAPK
MAP kinases	MAPK
MAP1	MAP1
MAP1 family	MAP1
MAP1-family proteins	MAP1
MAP1LC3	MAP1LC3
MAP2 family	MAP2
MAP2-family proteins	MAP2
MAP2K	MAP2K
MAP3K	MAP3K
MAPK	MAPK
MAPK kinase	MAP2K
MAPK kinase kinase	MAP3K
MAPK p38	p38
MAPKK kinases	MAP3K
MAPKKK	MAP3K
MAPKs	MAPK
MAPRE	MAPRE
MCM	MCM
MED	MED
MEF2	MEF2
MEF2 family	MEF2
MEK	MEK
MEK 1/2	MEK
MEK1/2	MEK
MGAT	MGAT
MGluR	GRM
MINDY	MINDY
MINDY deubiquinatase	MINDY
MINDY deubiquinatases	MINDY
MINDY deubiquitinase	MINDY
MINDY deubiquitinases	MINDY
MINDY deubiquitylase	MINDY
MINDY deubiquitylases	MINDY
MIRLET7	MIRLET7
MIRLET7A	MIRLET7A
MIRLET7F	MIRLET7F
MJD	MJD
MJD deubiquinating enzyme	MJD
MJD deubiquinating enzymes	MJD
MJD deubiquitinating enzyme	MJD
MJD deubiquitinating enzymes	MJD
MJD deubiquitylating enzyme	MJD
MJD deubiquitylating enzymes	MJD
MKKs	MAP2K
MKNK	MKNK
MLC	MYL
MMP	MMP
MMPs	MMP
MNK1 and MNK2	MKNK
MNK1 and MNK2 kinases	MKNK
MOB	MOB
MOB1	MOB1
MRC	MRC
MRN complex	MRN_complex
MRN-complex	MRN_complex
MRPS	MRPS
MT	Metallothionein
MTNR	MTNR
MYH	MYH
MYL	MYL
MYL-alkali	MYL_alkali
MYL-regulatory	MYL_regulatory
MYL-slow	MYL_slow
MYO1	MYO1
MYO15	MYO15
MYO18	MYO18
MYO3	MYO3
MYO5	MYO5
MYO7	MYO7
MYO9	MYO9
MYST	MYST
MYST family	MYST
MYST histone acetylase	MYST
MYST proteins	MYST
Macrophage-inflammatory-proteins	Macrophage_inflammatory_proteins
Maf subfamily	MAF
Mcm	MCM
Mechanosensitive-ion-channels	Mechanosensitive_ion_channels
Melatonin receptor	MTNR
Melatonin receptors	MTNR
Metallothionein	Metallothionein
Methyltransferase	Methyltransferases
Methyltransferases	Methyltransferases
Mhc	MYH
Microtubule-associated protein	Microtubule_associated_proteins
Microtubule-associated protein RP/EB family	MAPRE
Microtubule-associated proteins	Microtubule_associated_proteins
Microtubule-associated-proteins	Microtubule_associated_proteins
Mitochondrial Ribosome	Mitochondrial_Ribosome
Mitochondrial Ribosomes	Mitochondrial_Ribosome
Mitochondrial ribosome	Mitochondrial_Ribosome
Mitochondrial ribosomes	Mitochondrial_Ribosome
Mitochondrial-Ribosome	Mitochondrial_Ribosome
Mitoribosome	Mitochondrial_Ribosome
Mnk1 and Mnk2	MKNK
Mnk1 and Mnk2 kinases	MKNK
Mre11/Rad50 (M/R) DNA-repair complex	MRN_complex
Myosin	Myosin_complex
Myosin heavy chain	MYH
Myosin heavy chains	MYH
Myosin-complex	Myosin_complex
Myosin-family	Myosin_family
N-myc downstream regulated gene family	NDRG
NAD(P)H oxidase	NADPH_oxidase
NAD(P)H-oxidase	NADPH_oxidase
NADH dehydrogenase	NADH_dehydrogenase
NADH dehydrogenase (ubiquinone)	NADH_dehydrogenase
NADH-dehydrogenase	NADH_dehydrogenase
NADPH oxidase	NADPH_oxidase
NADPH-oxidase	NADPH_oxidase
NCOA	NCOA
NCOR	NCOR
NDR family	NDRG
NDR-family	NDRG
NDRG	NDRG
NF-E2	NFE
NF-E2-related factor	NFE
NF-Y	NFY
NF-kB	NFkappaB
NF-kappaB	NFkappaB
NF-kappaB Class 1	NFkappaB_1
NF-kappaB Class 2	NFkappaB_2
NF-kappaB Class I	NFkappaB_1
NF-kappaB Class II	NFkappaB_2
NF-kappaB Factors	NFkappaB
NF-kappaB TFs	NFkappaB
NF-kappaB class 1	NFkappaB_1
NF-kappaB class 2	NFkappaB_2
NF-kappaB class I	NFkappaB_1
NF-kappaB class II	NFkappaB_2
NF-kappaB complexes	NFkappaB
NF-kappaB dimers	NFkappaB
NF-kappaB factors	NFkappaB
NF-kappaB genes	NFkappaB
NF-kappaB subunits	NFkappaB
NF-kappaBs	NFkappaB
NF-kappabeta	NFkappaB
NF-κB	NFkappaB
NF-κB Class 1	NFkappaB_1
NF-κB Class 2	NFkappaB_2
NF-κB Class I	NFkappaB_1
NF-κB Class II	NFkappaB_2
NF-κB Factors	NFkappaB
NF-κB TFs	NFkappaB
NF-κB class 1	NFkappaB_1
NF-κB class 2	NFkappaB_2
NF-κB class I	NFkappaB_1
NF-κB class II	NFkappaB_2
NF-κB complexes	NFkappaB
NF-κB dimers	NFkappaB
NF-κB factors	NFkappaB
NF-κB genes	NFkappaB
NF-κB subunits	NFkappaB
NF-κBs	NFkappaB
NF-κβ	NFkappaB
NFAT	NFAT
NFE	NFE
NFY	NFY
NFkappaB	NFkappaB
NFkappaB complexes	NFkappaB
NFkappaB-1	NFkappaB_1
NFkappaB-2	NFkappaB_2
NFκB	NFkappaB
NFκB complexes	NFkappaB
NKD	NKD
NMDA Receptor	GRIN
NMDA receptor	GRIN
NMDA receptors	GRIN
NMDAR	GRIN
NOS	NOS
NOTCH	Notch
NPBWR	NPBWR
NPFFR	NPFFR
NPYR	NPYR
NRG	NRG
NRG-1-2	NRG_1_2
NRG-3-4	NRG_3_4
NRG1-NRG2	NRG_1_2
NRG1/2	NRG_1_2
NRG3-NRG4	NRG_3_4
NRG3/4	NRG_3_4
NRGs	NRG
NRXN	Neurexins
NTRK	NTRK
NTRKs	NTRK
Na(+),K(+)-ATPase	Na_K_ATPase
Na+/K+-exchanging ATPase	Na_K_ATPase
Na+/K+ATPase	Na_K_ATPase
Na,K-ATPase	Na_K_ATPase
Na,K-ATPase beta subunit	ATP1B
Na,K-ATPase β subunit	ATP1B
Na-K-ATPase	Na_K_ATPase
Na/K ATPase alpha	ATP1A
Na/K ATPase α	ATP1A
Na/K-ATPase	Na_K_ATPase
Natriuretic Peptide	Natriuretic_peptide
Natriuretic Peptides	Natriuretic_peptide
Natriuretic peptide	Natriuretic_peptide
Natriuretic peptides	Natriuretic_peptide
Natriuretic-peptide	Natriuretic_peptide
Netrin	Netrin
Neuregulin	NRG
Neuregulins	NRG
Neurexins	Neurexins
Neuropeptide-receptor	Neuropeptide_receptor
Neuropeptides	Neuropeptides
Neuropilin	Neuropilins
Neuropilins	Neuropilins
Neuroregulin	NRG
Notch	Notch
Nuclear Receptor Co-Repressor	NCOR
Nuclear factor erythroid 2-related factor	NFE
Nuclear receptor corepressor	NCOR
OGT-family	OGT_family
OR	OR
OR1	OR1
OR10	OR10
OR11	OR11
OR12	OR12
OR13	OR13
OR14	OR14
OR2	OR2
OR3	OR3
OR4	OR4
OR5	OR5
OR51	OR51
OR52	OR52
OR56	OR56
OR6	OR6
OR7	OR7
OR8	OR8
OR9	OR9
OTU	OTU
OTUB	OTUB
OTUD	OTUD
OTUD6	OTUD6
OTUD7	OTUD7
Opioid-receptor	Opioid_receptor
P2R	P2R
P2RX	P2RX
P2RY	P2RY
P2X	P2RX
P2X purinoreceptor	P2RX
P2X purinoreceptors	P2RX
P2X receptor	P2RX
P2X receptors	P2RX
P2Y receptor	P2RY
P38	p38
P38 MAPK	p38
P450	CYP
P450s	CYP
P53 family	p53_family
P70RSK	P70S6K
P70S6K	P70S6K
P90RSK	P90RSK
PAF1-complex	PAF1_complex
PAFc	PAF1_complex
PAK	PAK
PARP genes	PARP
PARPs	PARP
PARV	PARV
PATCHED	Patched
PBX	PBX
PBXs	PBX
PCSK	PCSK
PDE	PDE
PDE 3	PDE3
PDE1	PDE1
PDE1 family	PDE1
PDE3	PDE3
PDE3 family	PDE3
PDE4	PDE4
PDE4 family	PDE4
PDE4 isoforms	PDE4
PDE6	PDE6
PDE6 family	PDE6
PDE7	PDE7
PDE8	PDE8
PDEs	PDE
PDGF	PDGF
PDGF CC	PDGF_CC
PDGF DD	PDGF_DD
PDGF receptors	PDGFR
PDGF-AA	PDGF_AA
PDGF-AB	PDGF_AB
PDGF-BB	PDGF_BB
PDGF-CC	PDGF_CC
PDGF-DD	PDGF_DD
PDGF-aa	PDGF_AA
PDGF-ab	PDGF_AB
PDGF-bb	PDGF_BB
PDGF-cc	PDGF_CC
PDGF-dd	PDGF_DD
PDGFAA	PDGF_AA
PDGFAB	PDGF_AB
PDGFBB	PDGF_BB
PDGFR	PDGFR
PDGFR-AA	PDGFR_AA
PDGFR-AB	PDGFR_AB
PDGFR-BB	PDGFR_BB
PDGFR-alphaalpha	PDGFR_AA
PDGFR-alphabeta	PDGFR_AB
PDGFR-betabeta	PDGFR_BB
PDGFR-αα	PDGFR_AA
PDGFR-αβ	PDGFR_AB
PDGFR-ββ	PDGFR_BB
PDGFRalphaalpha	PDGFR_AA
PDGFRalphabeta	PDGFR_AB
PDGFRbetabeta	PDGFR_BB
PDGFRαα	PDGFR_AA
PDGFRαβ	PDGFR_AB
PDGFRββ	PDGFR_BB
PDH	PDH
PDKs	PDK
PFK	PFK
PFN	PFN
PGAM	PGAM
PI 3-kinase	PI3K
PI 3-kinases	PI3K
PI-3-K	PI3K
PI3 K	PI3K
PI3-K	PI3K
PI3-Kinase	PI3K
PI3-kinase	PI3K
PI3K	PI3K
PI3K p110 subunit	PI3K_p110
PI3K-p110	PI3K_p110
PI3K-p85	PI3K_p85
PI3Kinase	PI3K
PI3Ks	PI3K
PI4K	PI4K
PIK3C	PI3K_p110
PIK3R	PIK3R_I
PIK3R-I	PIK3R_I
PIM	PIM
PK-A	PKA
PKA	PKA
PKA C-alpha	PRKAC
PKA catalytic subunit	PRKAC
PKA catalytic subunits	PRKAC
PKA regulatory subunit	PRKAR
PKA regulatory subunits	PRKAR
PKB	AKT
PKB-Akt	AKT
PKB/Akt	AKT
PKC	PKC
PKG	PRKG
PKI	PKI
PKN	PKN
PLA2	PLA2
PLA2G2	PLA2G2
PLA2G4	PLA2G4
PLA2g2	PLA2G2
PLC	PLC
PLC-gamma	PLCG
PLC-γ	PLCG
PLCB	PLCB
PLCD	PLCD
PLCG	PLCG
PLD	PLD
PLOD	PLOD
PP-1	PPP1
PP1	PPP1
PP1 regulator	PPP1
PP1C	PPP1C
PP1R	PPP1R
PP1c	PPP1C
PP1r	PPP1R
PP2 phosphatases	PPP2
PP2A	PPP2
PP2A catalytic C subunit	PPP2C
PP2A regulatory subunit A	PPP2R_A
PP2A regulatory subunit B	PPP2R_B
PP2A-C	PPP2C
PP2Ac	PPP2C
PP2B	PPP3
PP2B catalytic subunit	PPP3C
PPAP2	PPAP2
PPAR	PPAR
PPP1	PPP1
PPP1C	PPP1C
PPP1R	PPP1R
PPP2	PPP2
PPP2C	PPP2C
PPP2R-A	PPP2R_A
PPP2R-B	PPP2R_B
PPP3	PPP3
PPP3C	PPP3C
PPP3R	PPP3R
PRC1-complex	PRC1_complex
PRC2	PRC2_complex
PRC2-complex	PRC2_complex
PRDUB-complex	PRDUB_complex
PRDX	PRDX
PRKAA	AMPK_alpha
PRKAB	AMPK_beta
PRKAC	PRKAC
PRKAG	AMPK_gamma
PRKAR	PRKAR
PRKG	PRKG
PRMT	PRMT
PTEFb	PTEFb
PTGER	PTGER
PTX	Pertussis_toxin
PYG	PYG
Pak	PAK
Parvin	PARV
Parvins	PARV
Patched	Patched
Pbx	PBX
Pcdhalpha	Protocadherin_alpha
Peroxiredoxin	PRDX
Peroxiredoxins	PRDX
Pertussis toxin	Pertussis_toxin
Pertussis-toxin	Pertussis_toxin
PhK	PhK
Phosphatase	Phosphatase
Phosphodiesterase	PDE
Phosphodiesterase 1	PDE1
Phosphodiesterase 3	PDE3
Phosphodiesterase 4	PDE4
Phosphodiesterase 6	PDE6
Phosphodiesterase 7	PDE7
Phosphodiesterase 8	PDE8
Phosphodiesterase-1	PDE1
Phosphodiesterase-3	PDE3
Phosphodiesterase-4	PDE4
Phosphodiesterase-6	PDE6
Phosphodiesterase-7	PDE7
Phosphodiesterase-8	PDE8
Phosphodiesterases	PDE
Phosphofructokinase	PFK
Phosphoglycerate mutase	PGAM
Phosphoinositide 3-kinase	PI3K
Phospholipase A2 Group IV	PLA2G4
Phospholipase C	PLC
Phospholipase C-beta	PLCB
Phospholipase C-delta	PLCD
Phospholipase C-β	PLCB
Phospholipase C-δ	PLCD
Phospholipase Cbeta	PLCB
Phospholipase Cdelta	PLCD
Phospholipase Cβ	PLCB
Phospholipase Cδ	PLCD
Phospholipase D	PLD
Phospholipase-C	PLC
Phosphorylase kinase	PhK
Pocket protein	Pocket_protein
Pocket protein family	Pocket_protein
Pocket proteins	Pocket_protein
Pocket-protein	Pocket_protein
Pol I	RNApo_I
Pol delta	DNA_polymerase_delta
Pol α	DNA_polymerase_alpha
Pol α-primase	DNA_polymerase_alpha
Pol α-primase complex	DNA_polymerase_alpha
Pol δ	DNA_polymerase_delta
Poly(ADP-ribose) polymerase	PARP
Poly(ADP-ribose) polymerases	PARP
Polycomb Repressive Complex 1	PRC1_complex
Polycomb Repressive Complex 2	PRC2_complex
Polycomb Repressive Complexes 1	PRC1_complex
Polycomb Repressive Complexes 2	PRC2_complex
Polycomb repressive complex 1	PRC1_complex
Polycomb repressive complex 2	PRC2_complex
Polycomb repressive complex PRC1	PRC1_complex
Polycomb repressive complex PRC2	PRC2_complex
Polycomb-repressive complex 1	PRC1_complex
Polycomb-repressive complex 2	PRC2_complex
Polα/primase complex	DNA_polymerase_alpha
Porin	Porins
Porins	Porins
Potassium channel	KCN
Potassium channels	KCN
Potassium-calcium-activated-channels	Potassium_calcium_activated_channels
Potassium-voltage-gated-channels	Potassium_voltage_gated_channels
Profilin	PFN
Profilins	PFN
Propionyl-CoA carboxylase	Propionyl_CoA_carboxylase
Propionyl-CoA-carboxylase	Propionyl_CoA_carboxylase
Proprotein convertase	PCSK
Proprotein convertases	PCSK
Protease	Protease
Proteases	Protease
Proteasome	Proteasome
Protein kinase A catalytic subunit	PRKAC
Protein kinase A catalytic subunits	PRKAC
Protein kinase A regulatory subunit	PRKAR
Protein kinase A regulatory subunits	PRKAR
Proteinase	Protease
Proteinases	Protease
Protocadherin alpha	Protocadherin_alpha
Protocadherin beta	Protocadherin_beta
Protocadherin-alpha	Protocadherin_alpha
Protocadherin-beta	Protocadherin_beta
Prx	PRDX
Ptdins 3-Kinase	PI3K
Ptdins 3-kinase	PI3K
Purinergic receptor	Purinergic_receptors
Purinergic-receptors	Purinergic_receptors
Pyruvate dehydrogenase kinase	PDK
RAB	RAB
RAC	RAC
RAF	RAF
RAL family	RAL
RAL guanine nucleotide dissociation stimulator like	RGL
RAL isoforms	RAL
RAL proteins	RAL
RALGDS-like	RGL
RAP1	RAP1
RAPGEF	RAPGEF
RAR	RAR
RAS	RAS
RAS association domain family	RASSF
RAS-association domain family	RASSF
RASA	RASA
RASAL	RASAL
RASGRF	RASGRF
RASGRP	RASGRP
RASSF	RASSF
RASSF family	RASSF
RBR E3 ligase	RBR_E3_ligase
RBR-E3-ligase	RBR_E3_ligase
RF-C	RFC
RF-X	RFX
RFC	RFC
RFX	RFX
RFX family	RFX
RFX proteins	RFX
RGL	RGL
RHO	RHO
RHOGDI	RhoGDI
RIG-I like receptors	RLR
RING E3 ligase	RING_E3_ligase
RING-E3-ligase	RING_E3_ligase
RIPK	RIPK
RLR	RLR
RLRs	RLR
RNA polymerase 1	RNApo_I
RNA polymerase I	RNApo_I
RNA polymerase II	RNApo_II
RNAP II	RNApo_II
RNApo-I	RNApo_I
RNApo-II	RNApo_II
ROBO	ROBO
ROCK	ROCK
ROR	ROR
RORs	ROR
RPA	RPA
RPS6KA	P90RSK
RSK	RSK
RSTK	RSTK
RSTK1	RSTK1
RSTK2	RSTK2
RTK	RTK
RTKs	RTK
RXR	RXR
RYR	RYR
Rab	RAB
Rab GTPase	RAB
Rab GTPases	RAB
Rabs	RAB
Raf	RAF
Ral family	RAL
Ral guanine nucleotide dissociation stimulator like	RGL
Ral isoforms	RAL
Ral proteins	RAL
Rap guanine nucleotide exchange factor	RAPGEF
Rap guanine nucleotide exchange factors	RAPGEF
Rap1	RAP1
RapGEFs	RAPGEF
Ras	RAS
Ras GTPase	RAS
Ras association domain family	RASSF
Ras-association domain family	RASSF
RasGAP	RasGAP
RasGAPs	RasGAP
Replication protein A	RPA
Rho family	RHO
Rho kinase	ROCK
Rho-GDI	RhoGDI
RhoGDI	RhoGDI
RhoGDIs	RhoGDI
S100	S100
S100A	S100A
S100a	S100A
S1P receptor	S1PR
S1PR	S1PR
S6K	P70S6K
SAA	SAA
SAPK	JNK
SCAR	SCAR
SCN	SCN
SCNN	SCNN
SENP	SENP
SERCA	SERCA
SERCAs	SERCA
SERPINB	SERPINB
SFK	SRC
SFKs	SRC
SGC	SGC
SHC	SHC
SIK	SIK
SLC2	SLC2A
SLC2A	SLC2A
SLRP	SLRP
SLRP-1	SLRP_1
SLRP-2	SLRP_2
SLRP-3	SLRP_3
SLRP-4	SLRP_4
SLRP-5	SLRP_5
SLRPs	SLRP
SLRR	SLRP
SLRRs	SLRP
SMAD	SMAD
SMAD 2/3	SMAD2_3
SMAD1-5-9	SMAD1_5_9
SMAD2-3	SMAD2_3
SMAD2/3	SMAD2_3
SMC1	SMC1
SMURF	SMURF
SNAI	SNAI
SNAI family	SNAI
SOD	SOD
SOS	SOS
SP	SP
SPHK	SPHK
SPRED	SPRED
SPRY	SPRY
SR Ca(2+)-ATPase	SERCA
SRC-family kinases	SRC
SREBF	SREBF
SREBF family	SREBF
STAG	STAG
STAT	STAT
STAT5	STAT5
STATs	STAT
STK3-4	STK3_4
STK3/4	STK3_4
STT3	STT3
SUMO specific peptidase	SENP
SUMO specific peptidases	SENP
SUMO-specific peptidase	SENP
SUMO-specific peptidases	SENP
SUR	Sulfonylurea_receptor
SWI and SNF complex	SWI_SNF
SWI-SNF	SWI_SNF
SWI/SNF	SWI_SNF
SWI/SNF complex	SWI_SNF
SWI/SNF-like	SWI_SNF
Sarcoglycan	Sarcoglycan_complex
Sarcoglycan-complex	Sarcoglycan_complex
Sarcoglycans	Sarcoglycan_complex
Scavenger receptor	SCAR
Scavenger receptors	SCAR
Selectin	Selectin
Shc	SHC
Shc family	SHC
Sialytransferase	GTF_family_29
Sialytransferases	GTF_family_29
Smad	SMAD
Smad2/3	SMAD2_3
Small Mitoribosomal Subunit	MRPS
Smc1	SMC1
Sodium channel	Sodium_channels
Sodium channels	Sodium_channels
Sodium-channels	Sodium_channels
Sodium-voltage-gated-channel-alpha-subunits	Sodium_voltage_gated_channel_alpha_subunits
Sodium-voltage-gated-channel-beta-subunits	Sodium_voltage_gated_channel_beta_subunits
Soluble Guanylate Cyclase	SGC
Soluble guanylyl cyclase	SGC
Soluble guanylyl/guanylate cyclase	SGC
Sp	SP
Spectrin beta	SPTB
SphK	SPHK
Sphingosine 1-phosphate receptor	S1PR
Sphingosine kinase	SPHK
Src family	SRC
Src family kinase	SRC
Src-kinases	SRC
Stat5	STAT5
Stearoyl-CoA desaturase	SCD
Sulfonylurea Receptor	Sulfonylurea_receptor
Sulfonylurea-receptor	Sulfonylurea_receptor
T-cell factor (TCF)/lymphoid enhancer factor	TCF_LEF
TAB	TAB
TAC	TAC
TAK-1 binding protein	TAB
TAK1 binding protein	TAB
TAK1-binding protein	TAB
TAOK	TAOK
TAP	TAP
TAP transporter	TAP
TAT-associated-kinase	TAT_associated_kinase
TCF	TCF_LEF
TCF-LEF	TCF_LEF
TCR	TCR
TEAD	TEAD
TFAP2	TFAP2
TFDP	TFDP
TFIIE	GTF2E
TFIIF	GTF2F
TGF beta	TGFB
TGF beta receptor	TGFBR
TGF β	TGFB
TGF β receptor	TGFBR
TGF-b	TGFB
TGF-beta	TGFB
TGF-beta family	TGFB
TGF-beta receptor	TGFBR
TGF-beta receptors	TGFBR
TGF-β	TGFB
TGF-β receptor	TGFBR
TGF-β receptors	TGFBR
TGFB	TGFB
TGFB family	TGFB
TGFBR	TGFBR
TGFBR family	TGFBR
TGFbeta	TGFB
TGFβ	TGFB
TGFβ receptor	TGFBR
TGFβ receptors	TGFBR
TGM	TGM
THBS	THBS
THR	THR
TIAM	TIAM
TIF-IB	TIF_IB
TIM22 complex	TIM22_complex
TIM22-complex	TIM22_complex
TK	TK
TLE family	TLE
TLR	TLR
TN	TN
TN-C	Troponin_C
TNF receptor associated factors	TRAF
TNF receptor-associated factors	TRAF
TNF-R superfamily	TNFRSF
TNF-receptor associated factors	TRAF
TNF-receptor family	TNFRSF
TNFR	TNFRSF
TNFR family	TNFRSF
TNFR subfamily	TNFRSF
TNFR superfamily	TNFRSF
TNFR superfamily members	TNFRSF
TNFR superfamily receptors	TNFRSF
TNFRSF	TNFRSF
TOP	TOP
TOP2	TOP2
TORC1	mTORC1
TORC2	mTORC2
TPCN	TPCN
TPNI	Troponin_I
TPNT	Troponin_T
TRAF	TRAF
TRAFs	TRAF
TRMT	TRMT
TRP	TRP
TRiC	CCT_complex
TSC	TSC
TUBA	TUBA
TUBB	TUBB
TUBG	TUBG
TXNRD	TXNRD
TcR	TCR
Tcf	TCF_LEF
Tcf/Lef	TCF_LEF
Tenascin	TN
Thioredoxin	TXN
Thioredoxin reductase	TXNRD
Thrombin-antithrombin	Thrombin_antithrombin
Thrombospondin	THBS
Thrombospondins	THBS
Tim22 complex	TIM22_complex
TnC	Troponin_C
Traf	TRAF
Transcription factor AP-2	TFAP2
Transglutaminase	TGM
Transglutaminases	TGM
Trk receptor	NTRK
Trk receptors	NTRK
Troponin	Troponin
Troponin-C	Troponin_C
Troponin-I	Troponin_I
Troponin-T	Troponin_T
Tryptase	Tryptase
Tubulin	Tubulin
Type I collagen	COL1
UBE2	UBE2
UCH deubiquinating enzyme	UCHL
UCH deubiquinating enzymes	UCHL
UCH deubiquitinating enzyme	UCHL
UCH deubiquitinating enzymes	UCHL
UCH deubiquitylating enzyme	UCHL
UCH deubiquitylating enzymes	UCHL
UCH family	UCHL
UCHL	UCHL
UGGT	UGGT
UGT	UGT
UNC5	UNC5
USP	USP
USP17L	USP17L
USP9	USP9
USPL	USPL
Ub	Ubiquitin
Ubiquitin	Ubiquitin
Ubiquitin C-terminal hydrolase	UCHL
Ubiquitin C-terminal hydrolase deubiquinating enzyme	UCHL
Ubiquitin C-terminal hydrolase deubiquinating enzymes	UCHL
Ubiquitin C-terminal hydrolase deubiquitinating enzyme	UCHL
Ubiquitin C-terminal hydrolase deubiquitinating enzymes	UCHL
Ubiquitin C-terminal hydrolase deubiquitylating enzyme	UCHL
Ubiquitin C-terminal hydrolase deubiquitylating enzymes	UCHL
Ubiquitin C-terminal hydrolase family	UCHL
Ubiquitin C-terminal hydrolases	UCHL
Ubiquitin C-terminal hydrolases deubiquinating enzyme	UCHL
Ubiquitin C-terminal hydrolases deubiquinating enzymes	UCHL
Ubiquitin C-terminal hydrolases deubiquitinating enzyme	UCHL
Ubiquitin C-terminal hydrolases deubiquitinating enzymes	UCHL
Ubiquitin C-terminal hydrolases deubiquitylating enzyme	UCHL
Ubiquitin C-terminal hydrolases deubiquitylating enzymes	UCHL
Ubiquitin C-terminal hydrolases family	UCHL
VAV	VAV
VAV family	VAV
VDAC	VDAC
VEGF	VEGF
VEGF receptor	VEGFR
VEGF receptors	VEGFR
VEGFR	VEGFR
VEGFRs	VEGFR
VTNR	VTNR
Vav	VAV
Voltage-gated-ion-channels	Voltage_gated_ion_channels
WNT	Wnt
WNT5	Wnt5
Wnt	Wnt
Wnt-5	Wnt5
Wnt5	Wnt5
XYLT	GCNT
Xylosyltransferase	GCNT
Xylosyltransferases	GCNT
Y box binding protein	YBX
Y-box-binding protein	YBX
YBX	YBX
YBX protein family	YBX
a-adrenoreceptor	ADRA
a-cathenin	CTNNA
acetyl CoA ligase	Acetyl_CoA_synthetase
acetyl CoA synthase	Acetyl_CoA_synthetase
acetyl-CoA carboxylase	ACC
acetyl-CoA synthetase	Acetyl_CoA_synthetase
acetyl-coenzyme A synthase	Acetyl_CoA_synthetase
acetylcholine receptor	CHRM
actin	Actin
actin filament	F_actin
actin-related protein	Actin_related_proteins
actin-related proteins	Actin_related_proteins
actinin	ACTN
actins	Actin
activin	Activin
activin A	Activin_A
activin AB	Activin_AB
activin protein	Activin
activin-A	Activin_A
activin-B	Activin_B
activinA	Activin_A
activins	Activin
acyl CoA dehydrogenase	ACAD
acyl-CoA dehydrogenase	ACAD
acyl-CoA oxidases	ACOX
adaptor protein complex 2	Adaptor_protein_II
adaptor protein complex 3	Adaptor_protein_III
adenosine deaminase	Adenosine_deaminase_family
adenylate cyclase	ADCY
adenylyl cyclase	ADCY
alcohol dehydrogenase	ADH
aldehyde dehydrogenase	ALDH
aldehyde dehydrogenase (NAD+)	ALDH
alkali myosin light chains	MYL_alkali
alpha adrenoceptor	ADRA
alpha catenin	CTNNA
alpha tubulin	TUBA
alpha(2)-ARs	ADRA2
alpha(2)-adrenoceptors	ADRA2
alpha-1,2-glucosyltransferase	ALG10
alpha-1,2-glucosyltransferases	ALG10
alpha-1,3-glucosyltransferase	ALG6_family
alpha-1,3-glucosyltransferases	ALG6_family
alpha-1,4-glucosyltransferase	ALG6_family
alpha-1,4-glucosyltransferases	ALG6_family
alpha-adrenergic receptor	ADRA
alpha-adrenoreceptor	ADRA
alpha-adrenoreceptors	ADRA
alpha-catenin	CTNNA
alpha1 adrenoceptor	ADRA
alpha1beta1gamma1	AMPK_A1B1G1
alpha1beta1gamma2	AMPK_A1B1G2
alpha1beta1gamma3	AMPK_A1B1G3
alpha1beta2gamma1	AMPK_A1B2G1
alpha1beta2gamma2	AMPK_A1B2G2
alpha2 adrenoceptor	ADRA2
alpha2-AR	ADRA2
alpha2beta1 integrin	ITGA2B1
alpha2beta1gamma1	AMPK_A2B1G1
alpha2beta2gamma1	AMPK_A2B2G1
alpha2beta2gamma2	AMPK_A2B2G2
alpha2beta2gamma3	AMPK_A2B2G3
alpha5beta1 integrins	FNR
alpha5beta1-integrin	FNR
alphavbeta3 integrins	VTNR
alphavbeta3-integrin	VTNR
angiotensin receptor	AGTR
angiotensin receptors	AGTR
angiotensin-receptor	AGTR
annexin A2 heterotetramer	Annexin_II_heterotetramer
annexin II heterotetramer	Annexin_II_heterotetramer
apoA	APOA
apolipoprotein	Apolipoprotein
apolipoprotein (a)	APOA
apolipoprotein A	APOA
apolipoprotein(A)	APOA
apolipoprotein(a)	APOA
apolipoproteins	Apolipoprotein
aspartate aminotransferase	GOT
aspartate transaminase	GOT
axonemal dynein	Axonemal_dynein
b-adrenergic receptor	ADRB
b-arrestin	ARRB
b-receptors	ADRB
barrestins	ARRB
beta 3-glycosyltransferase	Beta_3_4_GTF
beta 3-glycosyltransferases	Beta_3_4_GTF
beta 4-glycosyltransferase	Beta_3_4_GTF
beta 4-glycosyltransferases	Beta_3_4_GTF
beta Tubulin	TUBB
beta adrenergic receptor kinase	ADRBK
beta interferons	IFNB
beta tubulin	TUBB
beta-1,3-glucuronyltransferase	B3GAT
beta-1,3-glucuronyltransferases	B3GAT
beta-Tubulin	TUBB
beta-adrenergic receptor	ADRB
beta-adrenoreceptor	ADRB
beta-tubulin	TUBB
betaAR	ADRB
betaARK	ADRBK
bone morphogenetic protein I receptor	BMP_receptor_type_I
bone morphogenetic protein receptor 1	BMP_receptor_type_I
bone morphogenetic protein receptor 2	BMP_receptor_type_II
bone morphogenetic protein receptor type I	BMP_receptor_type_I
bone morphogenetic protein receptor type II	BMP_receptor_type_II
bone morphogenetic protein type I receptors	BMP_receptor_type_I
bone morphogenetic protein type II receptors	BMP_receptor_type_II
bradykinin receptor	BDKR
bradykinin receptors	BDKR
branched-chain alpha-keto acid dehydrogenase complex	BCKDC
branched-chain alpha-ketoacid dehydrogenase complex	BCKDC
branched-chain α-keto acid dehydrogenase complex	BCKDC
branched-chain α-ketoacid dehydrogenase complex	BCKDC
c-JNK	JNK
c-Jun N-terminal kinase	JNK
c-Jun NH2-terminal kinase	JNK
c1 complex	C1
cAK	PRKAC
cAMP-dependent PK	PKA
cAMP-dependent protein kinase	PKA
cPLA2	PLA2
cTnC	Troponin_C
cTnI	Troponin_I
cTnT	Troponin_T
cadherin	Cadherin
calcineurin	PPP3
calcium channel	Calcium_channels
calcium channels	Calcium_channels
calmodulin	CALM
calmodulindependent kinase II	CAMK2_complex
calpain	CAPN
carboxylesterase	Carboxylesterase
carboxylesterases	Carboxylesterase
casein kinase	CSNK
casein kinase 1	CSNK1
casein kinase 1 (CK1)	CSNK1
casein kinase 2	CK2
casein kinase I	CSNK1
casein kinase II	CK2
casein kinase II complex	CK2
caspase	Caspase
caspase-3/7	Caspase_3_7
caspases	Caspase
catalytic subunit of calcineurin	PPP3C
catenin alpha	CTNNA
catenin α	CTNNA
cathepsin	Cathepsin
cathepsins	Cathepsin
cation channel	Cation_channels
cation channels	Cation_channels
caveolin	CAV
cdk1/2	CDK1_2
cell cycle regulatory protein	CDK
chaperonin	CCT_complex
chaperonin containing TCP-1	CCT_complex
chaperonin-containing TCP1 complex	CCT_complex
chaperonin-containing t-complex polypeptide 1	CCT_complex
checkpoint kinase	CHEK
chemoattractant receptor	Chemokine_receptor
chemokine	Chemokine
chemokines	Chemokine
chk	CHK
choline esterase	Cholinesterase
choline kinase	CHK
cholinesterase	Cholinesterase
clade B serpins	SERPINB
class 1 NF-kappaBs	NFkappaB_1
class 1 NF-κBs	NFkappaB_1
class 2 NF-kappaBs	NFkappaB_2
class 2 NF-κBs	NFkappaB_2
class I HDACs	HDAC_I
class I NF-kappaBs	NFkappaB_1
class I NF-κBs	NFkappaB_1
class I histone deacetylases	HDAC_I
class II HDACs	HDAC_II
class II NF-kappaBs	NFkappaB_2
class II NF-κBs	NFkappaB_2
class II histone deacetylases	HDAC_II
class III HDACs	HDAC_III
class III histone deacetylases	HDAC_III
class IV HDACs	HDAC_IV
class IV histone deacetylases	HDAC_IV
clathrin	Clathrin
clathrin associated protein	Adaptor_protein
clathrin coat	Clathrin
cofilin	Cofilin
cohesin	Cohesin
cohesin complex	Cohesin
collagen IV	COL4
collagen beta(1-O)galactosyltransferase	COLGALT
collagen beta(1-O)galactosyltransferases	COLGALT
collagen type I	COL1
collagen type IV	COL4
collagen type V	COL5
complex II	ETC_complex_II
complex III	ETC_complex_III
connector enhancer of kinase suppressor of ras	CNKSR
connexin	GJ
connexins	GJ
creatine kinase	Creatine_kinase
cullin	CUL
cullin proteins	CUL
cullins	CUL
cyclase associated protein	CAP
cyclase associated proteins	CAP
cyclic AMP-dependent protein kinase	PKA
cyclic-AMP-dependent protein kinase	PKA
cyclin	Cyclin
cyclin A	Cyclin_A
cyclin B	Cyclin_B
cyclin E	Cyclin_E
cyclin G	Cyclin_G
cyclin dependent kinase inhibitors	CDKN
cyclin family	Cyclin
cyclin-dependent kinase inhibitor	CDKN
cyclin-dependent protein kinase inhibitors	CDKN
cyclins	Cyclin
cyclophilin	Cyclophilin
cyclophilins	Cyclophilin
cysteine rich secretory proteins	CRISP
cysteine-rich secretory proteins	CRISP
cytochrome	CYP
cytochrome P-450	CYP
cytochrome P-450 enzyme	CYP
cytochrome P-450 enzymes	CYP
cytochrome P-450 isozymes	CYP
cytochrome P450	CYP
cytochrome P450s	CYP
cytochrome bc1 complex	ETC_complex_III
cytochrome c oxidase	COX
cytochrome c oxidase subunit VIII	COX8
cytochrome p450	CYP
cytochromes P-450	CYP
cytoplasmic dynein	Cytoplasmic_dynein
cytosolic PLA2	PLA2
cytosolic phospholipase A(2)	PLA2
cytosolic phospholipase A2	PLA2
dTK	TK
death receptor	Death_receptor
death receptors	Death_receptor
deiodinase	Deiodinase
derived growth factor	PDGFR
desmoglein	Desmoglein
desmogleins	Desmoglein
desumolating isopeptidase	DESI
desumolating isopeptidases	DESI
desumoylating isopeptidase	DESI
desumoylating isopeptidases	DESI
deubiquinatase	Deubiquitinase
deubiquinatases	Deubiquitinase
deubiquinating enzyme	Deubiquitinase
deubiquinating enzymes	Deubiquitinase
deubiquitinase	Deubiquitinase
deubiquitinases	Deubiquitinase
deubiquitinating enzyme	Deubiquitinase
deubiquitinating enzymes	Deubiquitinase
deubiquitylase	Deubiquitinase
deubiquitylases	Deubiquitinase
deubiquitylating enzyme	Deubiquitinase
deubiquitylating enzymes	Deubiquitinase
diacyl glycerol kinase	DGK
diacylglycerol kinase	DGK
discoidin domain receptor family	DDR
discoidin domain receptors	DDR
discoidin domain-containing receptor	DDR
dishevelled	DVL
dopamine receptor	DRD
dopamine receptors	DRD
dynamin	DNM
dynamin family	DNM
dynein	Dynein
dynein complex	Dynein
dynein complexes	Dynein
dynein motor	Dynein
dynein motor complex	Dynein
dynein motors	Dynein
dyneins	Dynein
dystrophin glycoprotein	DGC
dystrophin glycoprotein complex	DGC
dystrophin-associated glycoprotein complex	DGC
dystrophin-glycoprotein complex	DGC
eIF2B	EIF2B
eIF4A	EIF4A
eIF4G	EIF4G
early growth response proteins	EGR
elastase	ELA
endothelin	EDN
endothelin receptor	EDNR
endothelin receptors	EDNR
endothelin-1 receptor	EDNR
endothelin-1 receptors	EDNR
endothelins	EDN
enolase	ENO
eotaxin	Eotaxin
eotaxins	Eotaxin
ephrin	EFN
ephrin receptor	Ephrin_receptor
ephrins	EFN
epsin	EPN
epsins	EPN
erbB	ERBB
ethanolamine kinase	CHK
eukaryotic elongation factor	EEF
eukaryotic initiation factor-4A	EIF4A
exocyst	EXOC
exocyst complex	EXOC
exostosin glycosyltransferase family	EXT
extracellular signal-regulated kinase	ERK
ezrin-radixin-moesin	ERM
ezrin/radixin/moesin	ERM
farnesyltransferase	FNT
fatty acid binding protein	FABP
fermitin	FERMT
fermitins	FERMT
fibrin	Fibrin
fibrinogen	Fibrinogen
fibronectin receptor	FNR
flotillin	FLOT
follicle-stimulating hormone	FSH
foxA	FOXA
foxD	FOXD
fructose-bisphosphate aldolase	ALDO
fucosyltransferase	FUT
fucosyltransferases	FUT
g6pase	G6Pase
gIV-PLA(2)	PLA2G4
gamma secretase	Gamma_secretase
gamma tubulin	TUBG
gamma-aminobutyric-acid A receptor	GABR
gamma-secretase	Gamma_secretase
gamma-tubulin	TUBG
general transcription factor II E	GTF2E
general transcription factor II F	GTF2F
glucose transporter	SLC2A
glucose transporters	SLC2A
glutamate decarboxylase	GAD
glutamate metabotropic receptors	GRM
glutamate oxaloacetate transaminase	GOT
glutamic acid decarboxylase 	GAD
glutamic-oxaloacetic transaminase	GOT
glutathione S-transferase	GST
glutathione peroxidase	GPX
glutathione-S-transferase	GST
glycogen phosphorylase	PYG
glycogen phosphorylases	PYG
glycogen synthase	GYS
glycogenin	GTF_family_8
glycoprotein Ib-V-IX complex	GPIb_IX_V
glycosylphosphatidylinositol transamidase complex	GPIT
glycosyltransferase family 2	GTF_family_2
glycosyltransferase family 29	GTF_family_29
glycosyltransferase family 6	GTF_family_6
glycosyltransferase family 8	GTF_family_8
glycosyltransferase family 90	GTF_family_90
gonadotropin releasing hormone	GNRH
gonadotropin-releasing hormone	GNRH
group IV-PLA(2)	PLA2G4
guanylate cyclase	GUCY
guanylyl cyclase	GUCY
h9-1-1 complex	9_1_1
hAxin	AXIN
hCG	hCG
hER	ESR
hH	HRH
haem oxygenase	HMOX
heat shock protein family B	HSPB
hedgehog protein	Hedgehog
hedgehog signaling proteins	Hedgehog
heme oxygenase	HMOX
hemoglobin	Hemoglobin
hexosaminidase	HEX
histamine receptor	HRH
histamine receptors	HRH
histone	Histone
histone H1	Histone_H1
histone H2A	Histone_H2A
histone H2B	Histone_H2B
histone H3	Histone_H3
histone H4	Histone_H4
histone deacetylase	HDAC
histone deacetylases	HDAC
histone-3	Histone_H3
histones	Histone
homeodomain iroquois proteins	IRX
hypoxia-inducible factors	HIF
il23	IL23
inhibin	Inhibin
inhibin A	Inhibin_A
inhibin B	Inhibin_B
inhibin-A	Inhibin_A
inhibin-B	Inhibin_B
inhibin-a	Inhibin_A
inhibin-b	Inhibin_B
initiation factor 4E binding proteins	EIF4EBP
insulin receptor family	INSR
insulin receptor substrate	IRS
insulin receptor/insulin-like growth factor receptor family	INSR
insulin-like growth factor binding proteins	IGFBP
integrin	Integrins
integrin alpha	ITGA
integrin receptors	Integrins
integrin α5β1	FNR
integrin αIIbβ3	ITGA2B3
integrins	Integrins
integrins alphavbeta3	VTNR
interferon	Interferon
interferon beta	IFNB
interferon gamma receptor	Interferon_gamma_receptor
interferon induced transmembrane protein	IFITM
interferon induced transmembrane proteins	IFITM
interferon β	IFNB
interferon γ receptor	Interferon_gamma_receptor
interferon-gamma receptor	Interferon_gamma_receptor
interferon-α/β receptor	IFNAR
interferon-γ receptor	Interferon_gamma_receptor
interleukin 23	IL23
interleukin-23	IL23
josephin deubiquinatase	MJD
josephin deubiquinatases	MJD
josephin deubiquitinatase	MJD
josephin deubiquitinatases	MJD
josephin deubiquitylase	MJD
josephin deubiquitylases	MJD
josephin domain containing	MJD
kallikrein	KLK
kallikrein-related peptidases	KLK
kindlin	FERMT
kindlins	FERMT
kinesin	Kinesin
kinesins	Kinesin
kinetochore	Kinetochore
kinetochore centromere binding factor 3	CBF3
kinetochore complex	Kinetochore
kinetochores	Kinetochore
laminin 332	Laminin_332
laminin 332 chains	Laminin_332
laminin-332	Laminin_332
laminin-332 chains	Laminin_332
laminin-5	Laminin_332
large mitoribosomal subunit	MRPL
large subunit of the mammalian mitochondrial ribosome	MRPL
large tumor suppressor kinase	LATS
large tumor suppressor kinases	LATS
ligand-gated ion channel	Ligand_gated_ion_channels
ligand-gated ion channels	Ligand_gated_ion_channels
liver X receptor	LXR
liver X receptors	LXR
long-chain acyl-CoA synthetase	ACSL
luteinizing hormone	LH
luteinizing-hormone	LH
mGluRs	GRM
mTORC1	mTORC1
mTORC2	mTORC2
mammalian mitochondrial ribosome	Mitochondrial_Ribosome
mannose receptor	MRC
mannose receptors	MRC
mechanosensitive ion channel	Mechanosensitive_ion_channels
mechanosensitive ion channels	Mechanosensitive_ion_channels
melatonin receptor	MTNR
melatonin receptors	MTNR
membrane attack	MAC
membrane attack complex	MAC
metabotrophic glutamate receptor	GRM
metabotropic glutamate receptor	GRM
metallothionein	Metallothionein
methyltransferase	Methyltransferases
methyltransferases	Methyltransferases
microtubule motor cytoplasmic dynein	Cytoplasmic_dynein
microtubule-associated protein	Microtubule_associated_proteins
microtubule-associated protein RP/EB family	MAPRE
microtubule-associated proteins	Microtubule_associated_proteins
mini-chromosome maintenance complex	MCM
minichromosome maintenance complex	MCM
minichromosome maintenance protein complex	MCM
mitochondrial ribosomal large subunit	MRPL
mitochondrial ribosomal small subunit	MRPS
mitochondrial ribosomes	Mitochondrial_Ribosome
mitogen activated protein kinase	MAPK
mitogen activated protein kinases	MAPK
mitogen-activated protein kinase	MAPK
mitogen-activated protein kinase kinase	MAP2K
mitogen-activated protein kinases	MAPK
mitoribosome	Mitochondrial_Ribosome
motif interacting with Ub-containing novel DUB family	MINDY
motif interacting with ubiquitin-containing novel DUB family	MINDY
motif interacting with ubiquitin-containing novel deubiquinating enzyme family	MINDY
motif interacting with ubiquitin-containing novel deubiquinating enzymes family	MINDY
motif interacting with ubiquitin-containing novel deubiquitinating enzyme family	MINDY
motif interacting with ubiquitin-containing novel deubiquitinating enzymes family	MINDY
motif interacting with ubiquitin-containing novel deubiquitylating enzyme family	MINDY
motif interacting with ubiquitin-containing novel deubiquitylating enzymes family	MINDY
motor dynein	Dynein
motor protein dynein	Dynein
myosin	Myosin_complex
myosin alkali light chain	MYL_alkali
myosin alkali light chain proteins	MYL_alkali
myosin heavy chain	MYH
myosin heavy chain genes	MYH
myosin heavy chain isoforms	MYH
myosin heavy chain protein	MYH
myosin heavy chains	MYH
myosin light chain	MYL
myosin light chain protein	MYL
myosin light chains	MYL
nAChR	CHRN
naked cuticle	NKD
natriuretic peptide	Natriuretic_peptide
natriuretic peptides	Natriuretic_peptide
netrin	Netrin
neuregulin	NRG
neuregulin family	NRG
neuregulins	NRG
neuropeptide	Neuropeptides
neuropeptide FF receptor	NPFFR
neuropeptide FF receptors	NPFFR
neuropeptide Y receptor	NPYR
neuropeptide Y receptors	NPYR
neuropeptide receptor	Neuropeptide_receptor
neuropeptide receptors	Neuropeptide_receptor
neuropeptides	Neuropeptides
neuropeptides B and W receptor	NPBWR
neuropeptides B and W receptors	NPBWR
neuropilin	Neuropilins
neuropilins	Neuropilins
neuroregulin	NRG
nicotine class acetylcholine receptors	CHRN
nicotinic acetylcholine receptor	CHRN
non-ELR-CXC chemokines	CXCL_ELR_negative
nuclear factor Y	NFY
nuclear factor-Y	NFY
nuclear receptor co-repressor	NCOR
nuclear receptor corepressor	NCOR
ofalpha(2)-adrenoceptor	ADRA2
ofα(2)-adrenoceptor	ADRA2
olfactory receptor	OR
olfactory receptors	OR
opioid receptor	Opioid_receptor
opioid receptors	Opioid_receptor
outer dynein	Axonemal_dynein_ODA
ov-serpins	SERPINB
p-38	p38
p-CaMKII	CAMK2_complex
p110	PI3K_p110
p14-3-3	p14_3_3
p160/SRC	NCOA
p38	p38
p38 MAPK	p38
p38 MAPKs	p38
p38 SAPK	p38
p38-MAPK	p38
p38MAPK	p38
p42 and p38 MAP kinases	ERK
p42 and p38 MAPK	ERK
p42 and p38 MAPKs	ERK
p42 and p44	ERK
p42 and p44 MAPK	ERK
p42 and p44MAP kinase	ERK
p42(mapk) and p44(mapk)	ERK
p42/44	ERK
p44 and p42	ERK
p450	CYP
p53 Family	p53_family
p53 family	p53_family
p53-family	p53_family
p53/p63/p73 family	p53_family
p70 S6 kinase	P70S6K
p70RSK	P70S6K
p85	PI3K_p85
p90RSK	P90RSK
parvin	PARV
parvins	PARV
pbx	PBX
peroxiredoxin	PRDX
peroxiredoxins	PRDX
pertussis toxin	Pertussis_toxin
phosphatase	Phosphatase
phosphatase PP2A	PPP2
phosphatidylinositol 3-kinase	PI3K
phosphatidylinositol 4-kinase	PI4K
phospho-ERK1/2	ERK
phosphodiesterase	PDE
phosphodiesterase 1	PDE1
phosphodiesterase 3	PDE3
phosphodiesterase 4	PDE4
phosphodiesterase 6	PDE6
phosphodiesterase 7	PDE7
phosphodiesterase 8	PDE8
phosphodiesterase-1	PDE1
phosphodiesterase-3	PDE3
phosphodiesterase-4	PDE4
phosphodiesterase-6	PDE6
phosphodiesterase-7	PDE7
phosphodiesterase-8	PDE8
phosphodiesterases	PDE
phosphoinositide 3-kinase	PI3K
phosphoinositide-3 kinase	PI3K
phospholipase A2	PLA2
phospholipase A2 group-II	PLA2G2
phospholipase A2 group-IV	PLA2G4
phospholipase C	PLC
phospholipase C-beta	PLCB
phospholipase C-delta	PLCD
phospholipase C-β	PLCB
phospholipase C-δ	PLCD
phospholipase Cbeta	PLCB
phospholipase Cdelta	PLCD
phospholipase Cβ	PLCB
phospholipase Cδ	PLCD
phospholipase D	PLD
phospholipase-C	PLC
phosphorylase kinase	PhK
pocket protein	Pocket_protein
pocket protein family	Pocket_protein
pocket proteins	Pocket_protein
pol delta	DNA_polymerase_delta
pol α	DNA_polymerase_alpha
pol α-primase	DNA_polymerase_alpha
pol α-primase complex	DNA_polymerase_alpha
pol δ	DNA_polymerase_delta
polycomb Repressive Complex (PRC) 1	PRC1_complex
polycomb repressive complex 1	PRC1_complex
polycomb repressive complex 2	PRC2_complex
polα/primase complex	DNA_polymerase_alpha
porin	Porins
porins	Porins
potassium channel	KCN
potassium channels	KCN
profilin	PFN
profilins	PFN
propionyl-CoA carboxylase	Propionyl_CoA_carboxylase
proprotein convertase	PCSK
proprotein convertases	PCSK
prostaglandin E receptor	PTGER
protease	Protease
proteases	Protease
proteasome	Proteasome
proteasome endopeptidase	Proteasome
protein farnesyltransferase	FNT
protein kinase A	PKA
protein kinase A catalytic subunit	PRKAC
protein kinase A catalytic subunits	PRKAC
protein kinase A regulatory subunit	PRKAR
protein kinase A regulatory subunits	PRKAR
protein kinase C	PKC
protein kinase G	PRKG
protein phosphatase 2	PPP2
protein phosphatase 2B	PPP3
protein phosphatases	Phosphatase
proteinase	Protease
proteinases	Protease
purinergic receptor	Purinergic_receptors
purinergic receptors	Purinergic_receptors
pyruvate dehydrogenase (acetyl-transferring)	PDH
pyruvate dehydrogenase kinase	PDK
rPKA	PRKAR
rab	RAB
rab GTPases	RAB
rab proteins	RAB
rac	RAC
raf protein	RAF
ral guanine nucleotide dissociation stimulator like	RGL
receptor tyrosine kinase-like orphan receptor	ROR
receptor tyrosine kinase-like orphan receptors	ROR
regulatory A subunit of PP2A	PPP2R_A
regulatory B subunit of PP2A	PPP2R_B
regulatory family X	RFX
regulatory myosin light chain	MYL_regulatory
regulatory subunit of calcineurin	PPP3R
replication factor C	RFC
replication protein A	RPA
retinoic acid receptors	RAR
retinoid X receptors	RXR
retinoid-X receptor	RXR
rhoGDI	RhoGDI
s6k	P70S6K
sGC	SGC
salt inducible kinase	SIK
sarcoglycan	Sarcoglycan_complex
sarcoglycans	Sarcoglycan_complex
sarcoplasmic/endoplasmic reticulum calcium ATPase	SERCA
scavenger receptor	SCAR
scavenger receptors	SCAR
sentrin specific protease	SENP
sentrin specific proteases	SENP
sentrin-specific protease	SENP
sentrin-specific proteases	SENP
serine/threonine protein kinase CK1	CSNK1
sialytransferase	GTF_family_29
sialytransferases	GTF_family_29
slow myosin	MYL_slow
smad	SMAD
small HSPs	HSPB
small leucine rich proteoglycan	SLRP
small leucine rich proteoglycan family	SLRP
small leucine rich proteoglycans	SLRP
small leucine-rich proteoglycan	SLRP
small leucine-rich proteoglycan family	SLRP
small leucine-rich proteoglycans	SLRP
small mitoribosomal subunit	MRPS
small subunit of the mammalian mitochondrial ribosome	MRPS
sodium channel	Sodium_channels
sodium channels	Sodium_channels
sphingosine kinase	SPHK
sphingosine-1-phosphate receptors	S1PR
src kinases	SRC
stearoyl-CoA 9-desaturase	SCD
stearoyl-CoA desaturase	SCD
sterol regulatory element binding protein	SREBF
sterol regulatory element-binding factor	SREBF
succinate dehydrogenase	ETC_complex_II
succinate dehydrogenase (ubiquinone)	ETC_complex_II
sulfonylurea receptor	Sulfonylurea_receptor
sulfonylurea receptors	Sulfonylurea_receptor
tea domain	TEAD
tenascin	TN
thioredoxin	TXN
thioredoxin reductase	TXNRD
thioredoxins	TXN
thrombin-anti-thrombin III complexes	Thrombin_antithrombin
thrombospondin	THBS
thrombospondin protein	THBS
thrombospondins	THBS
thyroid hormone receptor	THR
tissue kallikrein	KLK
tissue kallikreins	KLK
topoisomerase	TOP
topoisomerase II	TOP2
transcription factor AP-2	TFAP2
transcription factor DP	TFDP
transcription factor II E	GTF2E
transcription factor II F	GTF2F
transcription factor IIE	GTF2E
transcription factor IIF	GTF2F
transcriptional cofactor complex CRSP	CRSP
transforming growth factor beta	TGFB
transforming growth factor β	TGFB
transforming growth factor-beta	TGFB
transforming growth factor-β	TGFB
transglutaminase	TGM
transglutaminases	TGM
trk receptor	NTRK
trk receptors	NTRK
troponin	Troponin
troponin C	Troponin_C
troponin I	Troponin_I
troponin T	Troponin_T
troponin complex	Troponin
troponins	Troponin
tryptase	Tryptase
tryptases	Tryptase
tubulin	Tubulin
tubulin alpha chain	TUBA
tubulin beta	TUBB
tubulin beta chain	TUBB
tubulin gamma	TUBG
tubulin α chain	TUBA
tubulin β	TUBB
tubulin β chain	TUBB
tubulin γ	TUBG
type 2 phosphatidic acid phosphatase	PPAP2
type 2 phosphatidic acid phosphatases	PPAP2
type 4 cyclic nucleotide phosphodiesterase	PDE4
type I collagen	COL1
type II phosphatidic acid phosphatase	PPAP2
type II phosphatidic acid phosphatases	PPAP2
type V collagen	COL5
type-V collagen	COL5
ub	Ubiquitin
ubiquitin	Ubiquitin
ubiquitin conjugating enzyme	UBE2
ubiquitin-conjugating enzymes	UBE2
vascular endothelial growth factor	VEGF
vitronectin receptor	VTNR
voltage gated	Voltage_gated_ion_channels
voltage-gated	Voltage_gated_ion_channels
xylosyltransferase	GCNT
xylosyltransferases	GCNT
α catenin	CTNNA
α tubulin	TUBA
α(2)-ARs	ADRA2
α(2)-adrenoceptors	ADRA2
α-adrenergic receptor	ADRA
α-adrenoreceptor	ADRA
α-adrenoreceptors	ADRA
α-catenin	CTNNA
α1β1γ1	AMPK_A1B1G1
α1β1γ2	AMPK_A1B1G2
α1β1γ3	AMPK_A1B1G3
α1β2γ1	AMPK_A1B2G1
α1β2γ2	AMPK_A1B2G2
α2-AR	ADRA2
α2β1γ1	AMPK_A2B1G1
α2β2γ1	AMPK_A2B2G1
α2β2γ2	AMPK_A2B2G2
α2β2γ3	AMPK_A2B2G3
α5β1 integrin	FNR
αvβ3 integrin	VTNR
β adrenergic receptor kinase	ADRBK
β interferons	IFNB
β-adrenergic receptor	ADRB
β-adrenoreceptor	ADRB
β-hexosaminidase	Beta_HEX
βAR	ADRB
βARK	ADRBK
γ secretase	Gamma_secretase
γ tubulin	TUBG
γ-aminobutyric-acid A receptor	GABR
γ-tubulin	TUBG
